1,1,1,1,1,1,1,1,1,1,1,1,1
1,0,0,0,0,0,0,0,0,0,0,1,1
1,0,0,0,0,1,1,0,0,0,0,Q,1
1,0,0,0,0,0,0,0,0,0,0,1,1
1,0,0,1,0,1,1,0,1,0,0,1,1
1,0,0,0,0,0,0,0,0,0,0,1,1
1,0,0,1,0,1,1,0,1,0,0,1,1
1,0,0,0,0,0,0,0,0,0,0,1,1
1,0,0,1,0,1,1,0,1,0,0,1,1
1,0,0,0,0,0,0,0,0,0,0,A,1
1,0,0,0,0,0,0,0,0,0,0,1,1
1,1,1,1,1,1,1,1,1,1,1,1,1
