1,1,1,1,1,1,1,1,1,1
1,1,1,0,0,0,1,1,1,1
1,0,0,0,0,0,0,0,0,1
1,0,0,1,1,1,0,0,1,1
1,0,0,1,1,1,0,0,1,1
1,0,0,d,d,d,0,0,0,1
1,0,0,0,0,0,0,0,0,1
1,1,C,1,1,1,1,D,1,1
1,1,1,1,1,1,1,1,1,1